00000000000000000000
00001111111111110000
00010111111111101000
00011110011001111000
01101111011011110110
00011111111111111000
00010111111111101000
00101111100111110100
01100000100100000110
00000000111100000000
00000000011000000000
00000000000000000000
00000000000000000000
00000000000000000000
00000000000000000000
00000000000000000000
00000000000000000000
00000000000000000000
00000000000000000000
00000000000000000000