11111111111111111111
10000000011000000001
10000000111100000001
10000001111110000001
10000011111111000001
10000111122111100001
10001111111111110001
10011111111111111001
10121111111111112101
10000000000000000001
10000000000000000001
10101010100101010101
10202020200202020201
10000000000000000001
10000000000000000001
10000000000000000001
10000000000000000001
12121212122121212121
00000000000000000000
00000000000000000000
