00000000000000000000
00000000000000000000
00000000000000000000
00022202022022200000
00011101011011100000
00010101010010100000
00010101010010100000
00011101011011100000
00010001010011000000
00010001010010100000
00010001011010100000
00000000000000000000
00000000000000000000
00000000000000000000
00000000000000000000
00000000000000000000
00000000000000000000
00000000000000000000
00000000000000000000
00000000000000000000
