00101010101010101010
00000000000000000000
01212121212121212120
01111111111111111110
00000000000000000000
00011111111111111000
00011010111101011000
11011111111111111011
11000000000000000011
22011111111111111022
00111111111111111100
00000000000000000000
00000000000000000000
00000000000000000000
00000000000000000000
00000000000000000000
00000000000000000000
00000000000000000000
00000000000000000000
00000000000000000000