00000000000000000000
11111111111111111110
00000000000000000010
01101110111011101120
01001010101010001010
01101110111010001120
00101000101010001010
01101000101011101120
00000000000000000010
00000000000000000010
00000000000000000010
00000000021212121212
00000000000000000000
00000000000000000000
00000000000000000000
00000000000000000000
00000000000000000000
00000000000000000000
00000000000000000000
00000000000000000000
