11111111111111111111
10000000000000000001
10000000000000000001
10022222000022222001
10021112011021112001
10021112011021112001
10021112000021112001
10021112000021112001
10021112000021112001
10021112000021112001
10000000000000000001
10000000000000000001
10000200000000200001
10000000000000000001
10000000000000000001
10000000000000000001
10000000000000000001
10000000000000000001
10000000000000000001
10000000000000000001
