10000001110000011000
10000010001000100100
10000011110000100100
10000010000000100100
11110001110000011000
00000000000000000000
11111111111111111111
11111111111111111110
10001111111111110000
10000011111111000000
10000001111000000000
00000000100000000000
00000000000000000000
00000000000000000000
00000000000000000000
00000000000000000000
00000000000000000000
00000000000000000000
00000000000000000000
11111222222221111111
