00000000000000000000
00000000000000000000
00000000000000000000
11111111111111111111
11111111111111111111
11111111111111111111
01111111111111111110
00001111111111110000
00000011111111000000
00000001111000000000
00000000100000000000
00000000000000000000
00000000000000000000
00000000000000000000
00000000000000000000
00000000000000000000
00000000000000000000
00000000000000000000
00000000000000000000
11111222222221111111
