01111111111111111110
00000000010000000000
00000000011000000000
01111110001001111110
01111110011001111110
01111110010001111110
01100110011001100110
01100110001001100110
01100110011001100110
01111110010001111110
00000000011000000000
00000000000000000000
00000000000000000000
00000000000000000000
00000000000000000000
00000000000000000000
00000000000000000000
00000000000000000000
00000000000000000000
00000000000000000000
