00000001111111111100
01010101111111111100
00222000011111111100
01222100000001111100
01222100000001111100
00222000011000000000
01010100111100000000
00000011000010011111
00000020000002001111
00000211100111200111
00002111111111120011
00021111111111112002
00211111111111111200
02111111111111111120
21111221111122111112
00000000000000000000
00000000000000000000
00000000000000000000
00000000000000000000
00000000000000000000
