00000000000000000000
00000000000000000000
00000011000011000000
00000111100111100000
00001111121111110000
00011111121111111000
00011111112111111000
00011111112111111000
00001111121111110000
00000111121111100000
00000111112111100000
00000011112111000000
00000011121111000000
00000001121110000000
00000000112100000000
00000000012000000000
00000000000000000000
00000000000000000000
00000000000000000000
00000000000000000000
