00000000000000000000
00000000000000000000
01100000000000000110
02100110100001010120
01100001000000100110
01200000111111000210
01100000111111000110
02100011101011100120
01100110101010100110
01200011101011100210
01100222222222200110
01100000000000000110
01100000000000000110
00000000000000000000
00000000000000000000
00000000000000000000
00000000000000000000
00000000000000000000
00000000000000000000
00000000000000000000
