00000001111110001000
00212200000000221200
02111111111111111120
02111211111111211120
02111221111112211120
02111211111111211120
02111111111111111120
00111111122111111100
00111211111111111100
00111211111111111100
02100011111111002100
02100000011000000100
00200000011000000100
00000000011000000000
00000000011000000000
00000000011000000000
00000000011000000000
00000000011000000000
11000000011000000011
00022010222201022000
