00000000000000000000
01111111000011111110
01111111100111111110
00111111111111111100
00111111111111111100
00011111111111111000
00001111111111110000
00000111111111100000
00000000000000000000
00000000000000000000
00000000000000000000
00000000000000000000
00000000000000000000
00000000000000000000
00000000000000000000
00000000000000000000
00000000000000000000
00000000000000000000
00000000000000000000
00000000000000000000
