11111111111111111111
11212111111111121211
00212000011000021200
00010000011000001000
00111000011000011100
01111100011000111110
01111100022000111110
01111100000000111110
00222000000000022200
00222010111101022200
00000000000000000000
00000000000000000000
00000000000000000000
21212121000012121212
00000000000000000000
00000000000000000000
00000000000000000000
00000000000000000000
00000000000000000000
00000000000000000000
