11111111111111111111
11111111111111111111
00000000000000000000
00000000000000000000
01111100000000111110
01111100000000111110
01111100000000111110
01111100000000111110
01111100000000111110
01111100000000111110
01111100000000111110
00000000000000000000
00000000000000000000
22222220022002222222
00000000000000000000
00000000000000000000
00000000000000000000
00000000000000000000
00000000000000000000
00000000000000000000
