11111111111111111111
00000000000000000000
00000000000000000000
02200220011002200220
02111120011002111120
02111120011002111120
02111120011002111120
02111120011002111120
02111120011002111120
02222220011002222220
00000000000000000000
00000000000000000000
01010101010101010101
01010101010101010101
00000000000000000000
00000000000000000000
00000000000000000000
00000000000000000000
00000000000000000000
00000000000000000000
