00000000000000000000
00000000000000000000
00000202020202000000
20100010101010100102
20100111111111000102
20100011111111100102
20100111111111000102
20100011111111100102
21110101010101001112
20100020202020200102
20100000000000000102
20100000000000000102
20100000000000000102
20100000000000000102
20100112121212100102
22120000000000002122
20100111111111100102
20000111111111100002
00000111111111100000
00000000000000000000
