00000001111100000000
00110110111011011000
01210111010121010100
01211111000121100100
01211111222121100100
01211111000121000100
01111111000111000100
00111110000011001000
00111110000011001000
00011100000001010000
22011100000001010022
11001000000000100001
20001000000000100002
00001000000000100000
00000000000000000000
00000000000000000000
00000000000000000000
00000000000000000000
00000000000000000000
00000000000000000000
