00011111111111111000
00100011111100000000
00100010000000000000
00022200000002000000
00022220001112000000
00020020000002011000
00020020000002000000
00020020000002100000
00022220000002100000
00022210000002110000
00020200000002100000
00020220000112100000
00021020000002000000
00020020000102011000
00020020000002222000
00020020000002222000
00000000000000000000
00000000000000000000
00000000000000000000
00000000000000000000
