00000000000000000000
00000000000000000000
00000000000000000000
01100110110110110011
01100110110110110011
01100110110110110011
01100110110110110011
01100110110110110011
21102112112112112011
01100110110110110011
01100110110110110011
01100110110110110011
01100110110110110011
01100110110110110011
01100110110110110011
01100110110110110011
02220220220220220222
00000000000000000000
00000000000000000000
00000000000000000000
